##################################
#@......####........#...#..#.....#
#.#.###....#....###.#...##.#.#####
#.###...##.#.####.#.#.#....#.....#
#.#.#####..#.#....#.#.###.##.#####
#...#......#.#......#...#........#
##.#########.#.########.#######..#
#...#........#........#.#........#
###.#.##############..#.#.#.######
#.....#......#........#.#.#......#
#.#######.##.#.########.#.########
#.........#..#..........#.......!#
##################################