##################################
#@....#........#.#.#.#.#.#.#.#.#.#
#.#...#.#####.#.#.#.#.#.#.#.#.#..#
#.#.......#.#.#.#.#.#.#.#.#.#.#..#
#.#.#.#.#.#.#.#.#.#.#.#.#.#.#.#..#
#.#.#.#...#.#.#.#.#.#.#.#.#.#.#..#
#.#.#.#.#.#.#.#.#.#.#.#.#.#.#.#..#
#.#.#.#...#.#.....!.#.#.#.#.#.#..#
#.#.#.#.#.#.#.#.#.#.#.#.#.#.#.#..#
#.#.#.#...#.#.#.#.#.#.#.#.#.#.#..#
#.#.#.#.#.#.#.#.#.#.#.#.#.#.#.#..#
#.#.#.#.#.#.#.#.#.#.#.#.#.#......#
##################################
