##################################
#@......####............#..#.....#
#.#.###....#....###.#...##.#.#####
#.###...##...####.#.#.#....#.....#
#.#.#####..#.#....#.#.###.##.#####
#.#.#......#.#......#...#........#
##.#########.#.########.#######..#
#...#........#........#.#........#
###.#.##############..#.#.#.######
#.....#......#........#.#.#......#
#............##########.#.######.#
#..............................#!#
##################################
