##################################
#@#!....#..#........#...#..#.....#
#.#.###....#....###.#...##.#.#####
#.####..##.#.####.#.#.#....#.....#
#.#.#####..#.#....#.#.###.##.#####
#...#........#......#...#........#
##.#########.#.########.#######..#
#...#........#........#.#........#
###.################..#.#.#.######
#.....#......#........#.#.#......#
#.#######.##...########.#.########
#.........#..#..........#........#
##################################
