##################################
#@..................#...#..#.....#
#.#.###....#....###.#...##.#.#####
#.###...##.#.####.#.#.#....#.....#
#.#.#####..#.#....#..###.##.#####
#...#......#.#......#...#........#
##.#########.#.########.#######..#
#...#........#........#.#........#
###.#.######.#######..#.#.#.######
#...###......#........#.#.#......#
#.###!###.####.########.#.########
#...#............................#
##################################
